0000000000000000000000000000000000000000000000000
0666666606666666066666660666666606666666066666660
0666666606666666066666660666666606666666066666660
0666666606666666066666660666666606666666066666660
0666066606660666066606660666066606660666066606660
0666066606660666066606660666066606660666066606660
0666066606660666066606660666066606660666066606660
0666066606660666066606660666066606660666066606660
0666066606660666066606660666066606660666066606660
0666066606660666066606660666066606660666066606660
0666066606660666066606660666066606660666066606660
0666066606660666066606660666066606660666066606660
0666066606660666066606660666066606660666066606660
0666066606660666066606660666066606660666066606660
0666066606660666066606660666066606660666066606660
0666066606660666066606660666066606660666066606660
0666066606660666066606660666066606660666066606660
0666066606660666066606660666066606660666066606660
0666066606660666066606660666066606660666066606660
0666066606660666066606660666066606660666066606660
0666066606660666066606660666066606660666066606660
0666066666660666666606666666066666660666666606660
0666066666660666666606666666066666660666666606660
0676066666660666666606666666066666660666666606860
0000000000000000000000000000000000000000000000000