6666666666666666666666666666666666666666666666666
6666666666666666666666666666666666666666666666666
6666666666666666666666666666666666666666666666666
6666666666666666666666666666666666666666666666666
6666666622200111066666666600000011166666666666666
666666660666066l0666666666066606d6066666666666666
6666666616661666166666666616660666066666666666666
6666666616661666166666666616660666066666666666666
666666661666166610111111101666066l066666666666666
66666666066u6l6u6666666666666u6666066666666666666
6666666626660000066666666606000666066666666666666
666666662666066606667286666l662666066666666666666
6666666626660626166662666616262666066666666666666
6666666606660666166666666616662666066666666666666
6666666626660011160611160611100666066666666666666
66666666266666r6666022206u666666l6066666666666666
6666666626666666666601066666666666066666666666666
6666666606666660660660660660666666066666666666666
6666666620200000111061601110000022266666666666666
6666666666666666666666666666666666666666666666666
66666666666666666666r6u66666666666666666666666666
6666666666666666666666666666666666666666666666666
6666666666666666666666666666666666666666666666666
6666666666666666666666666666666666666666666666666
6666666666666666666666666666666666666666666666666