0000011100000666666666666666666666666666666666666
0666666666661666666666666666666666666666666666666
0666666666661666666666666666666666666666666666666
066666B666661666666666666666666666666666666666666
0R666661116R0111066666666666666666666666666666666
1661116666666666066666666666666666666666666666666
1666666666666866066666666666666666666666666666666
16666676B6666666066666666666666666666666666666666
0666600060000000066666666666666666666666666666666
0666666660666666666666666666666666666666666666666
0666666660666666666666666666666666666666666666666
0666666660666666666666666666666666666666666666666
0000600060666666666666666666666666666666666666666
6661666661666666666666666666666666666666666666666
6661666661666666666666666666666666666666666666666
6661111111666666666666666666666666666666666666666
6666666666666666666666666666666666666666666666666
6666666666666666666666666666666666666666666666666
6666666666666666666666666666666666666666666666666
6666666666666666666666666666666666666666666666666
6666666666666666666666666666666666666666666666666
6666666666666666666666666666666666666666666666666
6666666666666666666666666666666666666666666666666
6666666666666666666666666666666666666666666666666
6666666666666666666666666666666666666666666666666