6666666666666666666666666666666666666666666666666
6666666666666666666666666666666666666666666666666
6666666666666666666666666666666666666666666666666
6666666666666666666666666666666666666666666666666
6666666666666666666666666666666666666666666666666
6666666666666666666666666666666666666666666666666
6666666666666666666666666666666666666666666666666
6666666660222000111222000111222000111222266666666
66666666616666666666666666666d666666Y666266666666
66666666616r66666d66r66d666666666R666686266666666
6666666661666666666666666666666666666666266666666
6666666660666666666666666666666666666666066666666
6666666660666666666666666666666666666666066666666
66666666606766666Y66666B6666666666666666066666666
6666666662666666666666666666666666266666166666666
6666666662666666666666666666666666266666166666666
66666666626666666666u66666u6666666266666166666666
6666666660111000222000111000222111000266266666666
6666666666666666666666666666666666666022066666666
6666666666666666666666666666666666666666666666666
6666666666666666666666666666666666666666666666666
6666666666666666666666666666666666666666666666666
6666666666666666666666666666666666666666666666666
6666666666666666666666666666666666666666666666666
6666666666666666666666666666666666666666666666666