6666666666666666666666666666666666666666666666666
6666666666666666666666666666666666666666666666666
6666666666666666666666666666666666666666666666666
6666666666666666666666666666666666666666666666666
6666666666666666666666666666666666666666666666666
6666666666666666600000111000006666666666666666666
6666666666666666606666666666616666666666666666666
6666666666666666606666666666616666666666666666666
66666666666666666066666B6666616666666666666666666
666666666666666660R666661116R01110666666666666666
6666666666666666616611166666666660666666666666666
6666666666666666616666666666668660666666666666666
6666666666666666616666676B66666660666666666666666
6666666666666666606666000600000000666666666666666
6666666666666666606666666606666666666666666666666
6666666666666666606666666606666666666666666666666
6666666666666666606666666606666666666666666666666
6666666666666666600006000606666666666666666666666
6666666666666666666616666616666666666666666666666
6666666666666666666616666616666666666666666666666
6666666666666666666611111116666666666666666666666
6666666666666666666666666666666666666666666666666
6666666666666666666666666666666666666666666666666
6666666666666666666666666666666666666666666666666
6666666666666666666666666666666666666666666666666