0000000000000000000000000000000000000000000000000
0666666666666666666666666666666666666666666666660
0676666666666666666666666666666666666666666666660
0666666666666666666666666666666666666666666666660
0000000000000000000000000000000000000000000006660
0666666666666666666666666666666666666666666606660
0666666666666666666666666666666666666666666606660
0666666666666666666666666666666666666666666606660
0666000000000000000000000000000000000000066606660
0666066666666666666666666666666666666666066606660
0666066666666666666666666666666666666666066606660
0666066666666666666666666666666666666666066606660
0666066600000000000000000000000000000666066606660
0666066606666666666666666666666666668666066606660
0666066606666666666666666666666666666666066606660
0666066606666666666666666666666666666666066606660
0666066600000000000000000000000000000000066606660
0666066666666666666666666666666666666666666606660
0666066666666666666666666666666666666666666606660
0666066666666666666666666666666666666666666606660
0666000000000000000000000000000000000000000006660
0666666666666666666666666666666666666666666666660
0666666666666666666666666666666666666666666666660
0666666666666666666666666666666666666666666666660
0000000000000000000000000000000000000000000000000