1111111111111111211111111111111111111111111111111
1666666666666666666666666666666666666666666666661
1666666666666666666666666666666666666666666666661
1666666666666666666666666666666666666666666666661
1666666666666666666666666666666666666666666666661
1666666666666666666666666666666666666666666666661
1666666666666666666666666266666666666666666666661
1666666666666666666626666666666666666666666666661
1666666666666666666666666666666666666666666666661
1666666666666666666666666666666666666666666666661
1666666666666666666666666666666666666666666666661
1666666666666666666666666666666666666666666666661
1666666666666666666666666666666666666666666666661
1666666666666666666666666666666666666666666666661
1666666666666666666666666666666666666666666666661
1666666666666666666666666666666666666666666666661
1666666666666666666666666666666666666666666666661
1666666666666666666666666666666666666666666666661
1666666666666666666666666666666666666666666666661
1666666666666666666666666666666666666666666666661
1666666666666666666666666666666666666666666666661
1666666666666666666666666666666666666666666666661
1666666666666666666666666666666666666666666666661
1666666666666666666666666666666666666666666666661
1111111111111111111111111111111111111111111111111