6666666666666666666666666666666666666666666666666
6666666666666666666666666666666666666666666666666
6666666666666666666666666666666666666666666666666
6660222000111066666666666666666666601110002220666
66606r6666666066666666666666666666626666666661666
66601666666660666666666666666666666266666r6861666
6660666662666066666666666666666666626666666661666
6660266666666066666666666666666666606666666662666
6660666666666066666666666666666666606666666662666
6662166606666010022001020110200102106666166662666
6662661666660666660666666061666066616666666210666
6662666666166626666601626662666061666666616600666
6660r66666666666066666R66666666666666666666660666
66606666666666666666662661666600066B6666216661666
6660666266266660666606666666660666266666606661666
66616666666660201000102200120020010066666666Y1666
66616666l6666066666666666666666666606666666660666
6661666666006066666666666666666666606662666660666
6660666166666066666666666666666666606660166620666
6660676166B66066666666666666666666606666666660666
6660666166666066666666666666666666606666666660666
6660222000000066666666666666666666600000000000666
6666666666666666666666666666666666666666666666666
6666666666666666666666666666666666666666666666666
6666666666666666666666666666666666666666666666666