6666666666666666666666666666666666666666666666666
6666666666666666666666666666666666666666666666666
6666666666666666666666666666666666666666666666666
6666666666666666666666666666666666666666666666666
6666666666666666666666666666666666666666666666666
6666666666666666666100000000006666666666666666666
6666666666666666666166606666606666666666666666666
6666666666666666666166620006606666666666666666666
6666666666666666666066626666606666666666666666666
6666666660000000000066006666600000000000666666666
6666666661666666606666666602606666666660666666666
66666666616d66666666666666626066r6666660666666666
6666666661666666666106261066666666661110666666666
6666666660666666666066066166666666666660666666666
6666666660666666666666066666666666666660666666666
6666666660001110600066666066600060001110666666666
6666666666666666666166666166626666666666666666666
6666666666666666666166766168626666666666666666666
6666666666666666666106666166026666666666666666666
6666666666666666666622122011166666666666666666666
6666666666666666666666666666666666666666666666666
6666666666666666r666666666666666u6666666666666666
6666666666666666666666666666666666666666666666666
6666666666666666666666666666666666666666666666666
6666666666666666666666666666666666666666666666666