6666666666666666666666666666666666666666666666666
6666666666666666666666666666666666666666666666666
6666666666666666666666666666666666666666666666666
6666666666666000116666666666666666666666666666666
6666666666666166606666666666666666666666666666666
6666666666666166606666666666666666666666666666666
6666666666661166606666666666666666666666666666666
6666666666661666616666666666666666666666666666666
6666666666111666611106666666666666666666666666666
66666666661r666R666d00006666666666666666666666666
6666666666166666666606606666666666666666666666666
666661100006666u666666600166666666666666666666666
6666616666666616066666666166666666666666666666666
66666166666B6l666r6B66666166666666666666666666666
6666616676666606166666666066666666666666666666666
666661100066666d666600111066666666666666666666666
6666666606666666666616666666666666666666666666666
66666666066u866R666l16666666666666666666666666666
6666666600011166661116666666666666666666666666666
6666666666666066660666666666666666666666666666666
6666666666666066660666666666666666666666666666666
6666666666666000660666666666666666666666666666666
6666666666666661661666666666666666666666666666666
6666666666666661111666666666666666666666666666666
6666666666666666666666666666666666666666666666666