6666666666666666666666666666666666666666666666666
6666666666666666666666666666666666666666666666666
6666666666666666666666666666666666666666666666666
6666666666666666666666666666666666666666666666666
6666666600000000000000000000000000000000066666666
6666666606666666666606666660666666666666066666666
6666666606766666666606666666066666666066066666666
6666666606666666666606666666606666666066066666666
6666666600006666666666666666606666666066066666666
6666666606660666666666666666606666666666066666666
6666666606660666666666606666666606666666066666666
6666666606660066660006606666666606666660066666666
6666666606666866666666606666666606666606066666666
6666666606600066666666666666666666666066066666666
6666666606666606666660000006666666666666066666666
6666666606666660666660666666666660666666066666666
6666666606666666066660666666666660666000066666666
6666666606660666666660666666066660666666066666666
6666666606660666666666666666606666666006066666666
6666666606660666666666666666660666666666066666666
6666666600000000000000000000000000000000066666666
6666666666666666666666666666666666666666666666666
6666666666666666666666666666666666666666666666666
6666666666666666666666666666666666666666666666666
6666666666666666666666666666666666666666666666666