6666666666000066666666666666666666020006666666666
6666666666007600666666666666666662660006666666666
6666666666006666066666666666666306B60066666666666
666666666660066660666666666600066Y662666666666666
6666666666660666606660000061666666606666666666666
6666666666666066660006666600666660166666666666666
6666666666666600u666666G6666666636666006666666666
6666666666666666006666666666600066600806666666666
6666666666666666606666666666606660066606666666666
66666666666666660666666R6666661006666606666666666
66666666666666660600166666001606r6666u06666666666
66666666666666606B0006666600066066666606666666666
6666666666666660660006606610066066666606666666666
66666666666666606666d6666d66666066660006666666666
6666666666666660116666606666611066006666666666666
6666666666666660111660060G66111066066666666666666
66666666666666660116666666661106u6606666666666666
66666666666666666006666666u6006066660666666666666
6666666666666666606016222600606066660666666666666
66666666666666666066666R6666666666606666666666666
6666666666666666066636666366660666066666666666666
6666666666666660666636666366666060666666666666666
6666666666666660666663663666666006666666666666666
6666666666666000011103333001110000666666666666666
6666666666666666666666666666666666666666666666666