6666666666666666666666666666666666666666666666666
6666666666666666666666666666666666666666666666666
6666666666666666666666666011100000011116666666666
6666666666666666666666666066666666666616666666666
6666666666666666666666666066666666666616666666666
6666666666666666666666666066666666666616666666666
6666666666666666666666666066666666666616666666666
6666666666660000066600000060111666666616666666666
66666666666616660666166666B6661666666616666666666
6666666666661666066616666666661666011116666666666
6666666666661666011116666666661666066666666666666
6666666666660666666666666666661666066666666666666
6666666666660866666666666666661666066666666666666
6666666666660666666666666666660666066666666666666
6666666666661666666666666666666666066666666666666
6666666666661666666666666666666666066666666666666
66666666666616766666666666R6666666066666666666666
6666666666660000066601111060110666066666666666666
6666666666666666166666666666666666066666666666666
6666666666666666166666666666666666066666666666666
6666666666666666166666666666666666066666666666666
6666666666666666000000000000000111066666666666666
6666666666666666666666666666666666666666666666666
6666666666666666666666666666666666666666666666666
6666666666666666666666666666666666666666666666666