6666666666666666666666666666666666666666666666666
6000066666666666666666666666666666666666666600006
6066666666666666666666666666666666666666666666606
6067666666666666666666666666666666666666666666606
6066666666666666666666666666666666666666666666606
6000066666666666666666666666666666666666666666666
6666666666666666666666666666666666666666666666666
6666666666666666666666666666666666666666666666666
6600006666666666666666666666666666666666660000666
6606666666666666666666666666666666666666666660666
6606000066666666666666666666666666666666000060666
6606066666666666666666666666666666666666666060666
6666060000666666666666666666666666666600006066666
6666060666666666666666666666666666666666606066666
6666660666666666666666666666666666666666606666666
6666660666666666666666666666666666666666806066666
6666660666666666666666666666666666666666666066666
6666060666666666666666666666666666666666666060666
6666060000666666666666666666666666666666000060666
6606066666666666666666666666666666666666666660606
6606000066666666666666666666666666666666660000606
6606666666666666666666666666666666666666666666606
6600006666666666666666666666666666666666666600006
6666666666666666666666666666666666666666666666666
6666666666666666666666666666666666666666666666666