6666666666666666666666666666666666666666666666666
6666666666666666666666666666666666666666666666666
6666666666666666666666666666666666666666666666666
6666666666666666666666666666666666666666666666666
6666666666666666666666666666666666666666666666666
6666666666666666666666666666666666666666666666666
6666666666666600000000000000000666666666666666666
6666666666666616666666666666d60666666666666666666
6666666666666616666l66666666660666666666666666666
666666666666661666666666R666660666666666666666666
6666666666666601110666000006660000000006666666666
6666666666666616666666666606666666666606666666666
6666666666666616r6666666d6066666r6668606666666666
6666666666666616666666666606666666666606666666666
666666666666660666066606B606660666000006666666666
6666666666666616661666666606666666066666666666666
6666666666666616661666666606r666u6066666666666666
6666666666666616761666666606666666066666666666666
6666666666666600000000011101111111066666666666666
6666666666666666666666666666666666666666666666666
6666666666666666666666666666666666666666666666666
6666666666666666666666666666666666666666666666666
6666666666666666666666666666666666666666666666666
6666666666666666666666666666666666666666666666666
6666666666666666666666666666666666666666666666666