6666666666666666666666666666666666666666666666666
6000000006666666666666666666666666666666666666666
6066666606666666666666666666666666666666666666666
606766d606666666666666666666666666666666666666666
6066666606666666666666666666666666666666666666666
600006B616611122211111666666666666666666666666666
666616661111666B666660666666666666666666666666666
6666166666616666666660000133316666666666666666666
666616666661666R666660666G66636666666666666666666
666611116661116662666166G666636666666666666666666
6666266666666666626666666066636666666666666666666
666626Y666666666626666666066636666666666666666666
6666122211111122210000666066636666666666666666666
6666666666666666666660000166633333333333336666666
6666666666666666666666666366666666666666636666666
666666666666666666666666636666666666666d636666666
6666666666666666666666666333333333333066636666666
6666666666666666666666666666666666666166616666666
6666666666666666666666666666666666666266626666666
6666666666666666666666666666666666666368636666666
6666666666666666666666666666666666666066606666666
6666666666666666666666666666666666666123216666666
6666666666666666666666666666666666666666666666666
6666666666666666666666666666666666666666666666666
6666666666666666666666666666666666666666666666666