6666666666666666666666666666666666666666666666666
6666666666666666666666666666666666666666666666666
6666666666666666666666666666666666666666666666666
6666666666666666666666666666666666666666666666666
6666666666666666600006666666603330666666666666666
6666666666666666606606666666636660666666666666666
666666666666666660R8606666666366G0666666666666666
6666666666666666636663330000036662666666666666666
6666666666666666636666666666666662666666666666666
666666666666666663666666666r666662666666666666666
66666666666666666022266u6666666330666666666666666
6666666666666666666606666666663666666666666666666
6666666666666666666606666666660666666666666666666
6666666666666666666606666666662666666666666666666
6666666666666666600016666626666220666666666666666
6666666666666666606666666666666661666666666666666
6666666666666666606666666666666661666666666666666
666666666666666660B661000000026661666666666666666
66666666666666666067616666666266Y0666666666666666
6666666666666666606661666666626660666666666666666
6666666666666666601110666666602220666666666666666
6666666666666666666666666666666666666666666666666
6666666666666666666666666666666666666666666666666
6666666666666666666666666666666666666666666666666
6666666666666666666666666666666666666666666666666