6666666611116666666666666666666666666666666666666
6666666606616666666666666666666666666666666666666
6666666606616666666666666666666666666666666666666
6666666606610006666666666666666666666666666666666
6666666606666616666666666666666666666666666666666
6600000006666610001666666666666666666666666666666
660666666B666616660666666666666666666666666666666
6606666666666666860666666666666666666666666666666
6606666666111616660666666666666666666666666666666
6606666666666610001666666666666666666666666666666
6606666666666616666666666666666666666666666666666
6606766666666606666666666666666666666666666666666
6600001111111116666666666666666666666666666666666
6666666666666666666666666666666666666666666666666
6666666666666666666666666666666666666666666666666
6666666666666666666666666666666666666666666666666
6666666666666666666666666666666666666666666666666
6666666666666666666666666666666666666666666666666
6666666666666666666666666666666666666666666666666
6666666666666666666666666666666666666666666666666
6666666666666666666666666666666666666666666666666
6666666666666666666666666666666666666666666666666
6666666666666666666666666666666666666666666666666
6666666666666666666666666666666666666666666666666
6666666666666666666666666666666666666666666666666