6666666666000000000000000000000000000006666666666
6666666666066666666666660666666666666606666666666
6666666666066660006666660606666666666606666666666 
6666666666066660006666660606666666666606666666666
6666666666066660006666660600000066600006666666666
0000000000066666666666660660666666666600000000000
0666666666666666666666666660666666606666666666660
0666600006666660006666666666666666666666666666660
0666606666666660666666606660666666600066666666660
0666606666066660666666606660666666600066600000000
0600006666066666666666606860666666600066666666660
0606666000066666666666606660666600066666666666660
0606666666000066606666600000666600066666666666660
0606666666066666660666606660666600066666666666660
0666000666066666666666606760666666666666666666660
0666000666066666666666606660666666666660000066660
0666000666666666666666600666666666666666666066660
0666660000000066666666660666000066666666666066660
0666666666066666666000660666066666666666666066660
0000000000066600066000660666066666666600000000000
6666666666066600066000660000066666666606666666666
6666666666066600066666666000666666600006666666666
6666666666066666666666666000666666666606666666666
6666666666066666666666666000666666666606666666666
6666666666000000000000000000000000000006666666666