6666666666666666666666666666666666666666666666666
6666666666666666666666666666666666666666666666666
6666666666666666666666666666666666666666666666666
6666666666666666666666666666666666666666666666666
6666666666666666666666666666666666666666666666666
6666666666666666333333322223336666666666666666666
6666666666666666366666626666636666666666666666666
66666666666666663666666G6666l36666666666666666666
66666666666666663668666666l6626666666666666666666
6666666666666666366d66626666622266666666666666666
6666666666666666336663362666666266666666666666666
6666666666666666366663322666626266666666666666666
6666666666666666066660011666616266666666666666666
6666666666666666066660061666616266666666666666666
6666666666666666066666616666l16266666666666666666
66666666666666660B6r666666u6616266666666666666666
666666666666666606766u66Y666616266666666666666666
6666666666666666066666666666616266666666666666666
6666666666666666011100026222216266666666666666666
6666666666666666666666626666666266666666666666666
6666666666666666666666622222222266666666666666666
6666666666666666666666666666666666666666666666666
6666666666666666666666666666666666666666666666666
6666666666666666666666666666666666666666666666666
6666666666666666666666666666666666666666666666666