6666666666666666666666666666666666666666666666666
6666666666666666666666666666666666666666666666666
2022213120213131120333322331013220022003232122110
166B61666366632666661666B66666601366G636666666361
0676d6G6666d66666Y66R66d6616666B166d666R6G6660663
166R666066666632166666666666606236660666066666661
31301232303602310123313012110200113622100103266R3
3666666666666662626666666666666666666666660626G62
266666666666666666666266666u66666666661226663u6l2
166B6366G6666666266666666R66666066666666666636663
2366131001220310033220011322110112230120266616Y63
1666263666r66661666366666666266666G66666366606662
166106666663666666666Y66266R666666666686166606661
16G6366666r66666663266666666666066666366r66606B62
01660666001231002233333221300012021122d3366616660
26Y6666l666666666666666666666666666666666l6626662
3663066666666666666666666666666666666666666626661
3666236666666666666666666666666666666666666l16R61
0266310120333012012301023201220323021013321106660
1662666666666666666666666666666666666666626666661
16r66R666B666Y666G636r666B666Y666G666R666B6616u62
2666666666666666666666366666666666666666666661663
3231000202022131103213330120031000233112322233210
6666666666666666666666666666666666666666666666666
6666666666666666666666666666666666666666666666666