d666l666666l666r66B666d66066666066666666666666666
60006666666666666666666666666666666d66666l6666666
6076666666666666666666d606R66l6666666666666666666
60666666661666666666666666666666666666666u6666666
666666666616666u6666l6666666666666000666666666666
6666666666166666666666666666661666666666666666666
6666666r6666666666666111116666166666666666666666l
6666666666666666666662666666661666666666666666666
r66666666666r6666666626666666R6666666666666666666
6666666666666666666662666666666666666666616666666
Y6666666666666666666r666d6666l6r66666666666666d66
6666666606666666616666666666666666666666666666666
66r666660666r6666166l6866666666666666666666666l66
6666666606666666616666666666666666666266666666666
66666d666666u6666666u666l666666666666666662666666
6666666666666666666666666666666666666666666666666
66d6666l66666666666666666666666666666Y66666666666
666666666666666666666666666666666666666666666666B
u6666l666666l666666666666622266666666666666666666
666666666666666666666111666666666R666606666666666
66r66666u6666666611166666666666666666666666666666
66666666666666666666266666666666666666666r666666u
6666r666666Y6666666626u66666666666666666666666d62
6666666666666666666626666666666666666066666666662
6666666666666666666r66666666u66666666666666666222